かんしゅ	函手	名詞	
よろ	よろしくお願いします	記号	
なのか	なのか	接続詞	

あｂ	アルファベット	名詞	
あｂ	αβ	名詞	
もう	問題	名詞	
しくはない	如くはない	名詞	
しくなし	如くなし	名詞	

すがく	数学	名詞	
すはい	崇拝	名詞	
すち	数値	名詞	
すだん	数段	名詞	
すにん	数人	名詞	
すかい	数回	名詞	
すこう	崇高	名詞	
すしゅう	数週	名詞	
すしき	数式	名詞	
すじく	枢軸	名詞	
すじくこく	枢軸国	名詞	
すじつ	数日	名詞	
すみつ	枢密	名詞	
すれつ	数列	名詞	
すかげつ	数ヶ月	名詞	
すねん	数年	名詞	
すりょう	数量	名詞	
かんす	関数	名詞	
けいす	係数	名詞	
しす	指数	名詞	
かいす	回数	名詞	
はんす	半数	名詞	
かはんす	過半数	名詞	
きす	奇数	名詞	
ていす	定数	名詞	
ぎゃくす	逆数	名詞	
きょす	虚数	名詞	
しょうす	少数	名詞	

ｃご	直後	名詞	
ｃし	直視	名詞	
ｃかん	直感	名詞	
ｃきゅう	直球	名詞	
ｃと	ちょっと	名詞	
ｃかく	直角	名詞	
ｃせっ	直接	名詞	
かんせっ	関節	名詞	
かんせっ	間接	名詞	
きせっ	季節	名詞	
しょうせっ	小説	名詞	
ていせっ	定説	名詞	
ぎゃくせっ	逆接	名詞	
ぎゃくせっ	逆説	名詞	
じゅんせっ	順接	名詞	

っゅ	⇔	アルファベット	テスト
vv	💕	顔文字	
v	❤	記号	

どけい	同型	名詞	
どよう	同様	名詞	
どぜん	同然	名詞	
どこう	動向	名詞	
どこう	同行	名詞	
どこうかい	同好会	名詞	
どさ	動作	名詞	
どわ	童話	名詞	
どあげ	胴上げ	名詞	
どおん	同音	名詞	
どぎ	同義	名詞	
どいっ	同一	名詞	
どいっし	同一視	名詞	
どき	同期	名詞	
どし	動詞	名詞	
じゅんどし	準動詞	名詞	
じゅんどしく	準動詞句	名詞	
どしてき	動詞的	名詞	

さっきゃく	作曲	名詞	
さっきゃくか	作曲家	名詞	
さっきゃくしゃ	作曲者	名詞	
りょく	略	名詞サ変	
しょうりょく	省略	名詞サ変	
ひゅーちゃー	フューチャー	名詞	

さま	狭間	名詞	
あんえい	安永	名詞	

いる	ゐる	動詞一段	
